########################################
#______Z__C_OZ_____O_O__________O_ZZ___#
#_OPO______Z_________OC__OZZ___Z___O___#
#__________Z___Z____O_O__O____O___O_O__#
#O__ZZC____ZOO_____________OOOZZOOC_O__#
#_____OOZZ___________OZZO______OZO_OO__#
###############################____O___#
#_Z___O__C_Z__O_O___________C_OZ____O__#
#__C_____O_____O_________OZZO__C___O___#
#___O__O_O_______________OO_O__O_______#
#__ZO___O______OO__________OO__O_COO__Z#
#_C_______OOCZZOC___O____ZZO___O_Z__OO_#
#__ZZZO___OOZO_______ZOO_____ZO________#
#O________O____ZO_O______C____OZOZ_____#
#_OO_O______ZO_______O____O______Z_____#
#_________##############################
#ZZ__O___O______C___ZZOZO_______O______#
#______O_____O__O___O____________ZZ_Z__#
#__O___ZZO________O_CCO_____OOZZ______G#
#___Z____OCOO_____O_____ZOO______O_____#
#__C_____O___O____O_______ZZ_________O_#
########################################
