
########################################
#P_____________________________________#
######################################_#
#CCCCCCCCCCCCCCCCCCCCCCCCCCCCCCCCCCCCC_#
#C######################################
#C_____________________________________#
######################################_#
#OOOOOOOOOOOOOOOOOOOOOOOOOOOOOOOOOOOOO_#
#CCCCCCCCCCCCCCCCCCCCCCCCCCCCCCCCCCCCC_#
#C######################################
#COOOOOOOOOOOOOOOOOOOOOOOOOOOOOOOOOOOOO#
#C_____________________________________#
######################################_#
#OOOOOOOOOOOOOOOOOOOOOOOOOOOOOOOOOOOOO_#
#CCCCCCCCCCCCCCCCCCCCCCCCCCCCCCCCCCCCC_#
#C######################################
#COOOOOOOOOOOOOOOOOOOOOOOOOOOOOOOOOOOOO#
#C_____________________________________#
######################################_#
#_OOOOOOOOOOOOOOOOOOOOOOOOOOOOOOOOOOOO_#
#GCCCCCCCCCCCCCCCCCCCCCCCCCCCCCCCCCCCC_#
########################################
